11111111111111111111
11111111111111111111
11000000000000000011
11000000000000000011
11000000000000000011
11000000000000000011
11000000000000000011
11000000000000000011
11000000000000000011
11000000000000000011
11000000000000000011
11000000000000000011
11000000000000000011
11000000000000000011
11000000000000001111
11000001111100000011
11001100000000000011
11000000000000333011
11111111111111111111
11111111111111111111

