10000000000000000000000000
10000000000000000000000000
10000000000000000000000000
10000000000000000001111111
10000000000000001110001111
10000000000011001111100011
11111001111100011111111111
11111111111111110011111000
11111111111111112011111000
11111111111111111011111100
11111111111111111011111100
11111111111111111011111100
11111111111111111111111111