1111111111111111111
1111111111111111111
1100000000000000011
1100000000000000011
1100000000000000011
1100000000000000011
1100000000000000011
1100000000000000 11
1100000000000000311
1100000000000004 11
110000000000000  11
11000000000004 0011
1100000000000  0011
1100000004 00000011
110000000  00000011
11 004 000000000011
11200  000000000011
!    [-]11111111111
1111111111111111111

