10000000000000000000000000
10000000000000000000000000
10000000000000000000000000
10000333300000000022200000
1000000000000022001112200002200000330000033000033
12200000000000110011111000011
11122222222222110011111000011
11111111111111110011111000011
111111111111111120111112000112
111111111111111110111111000111
111111111111111110111111000111
111111111111111110111111000111
1111111111111111111111111111111111111111111111111111111111111111111111111111